type octile
height 8
width 12
map
............
....@.@@.@@.
@...@.@@.@@.
@.....@@.@@.
@...@.@@.@@.
@.....@@.@@.
....@.@@.@@.
@...........
